4 4 4 4 4 4 4 4 4 4 4 4 4 4 4 4 4 4 4 4 4 4 4 4 4 4 4 4 4 4 4 4 
4 1 0 3 0 3 0 3 0 3 0 3 4 4 4 4 4 4 4 4 0 3 0 3 0 3 0 3 0 3 5 4
4 0 4 4 4 4 4 4 4 4 4 0 4 4 4 4 4 4 4 4 3 4 4 4 4 4 4 4 4 4 0 4
4 3 4 4 4 4 4 4 4 4 4 3 4 4 4 4 4 4 4 4 0 4 4 4 4 4 4 4 4 4 3 4 
4 0 4 4 4 4 4 4 4 4 4 0 4 4 4 4 4 4 4 4 3 4 4 4 4 4 4 4 4 4 0 4 
4 3 4 4 4 4 4 4 4 4 4 3 4 4 4 4 4 4 4 4 0 4 4 4 4 4 4 4 4 4 3 4 
4 0 4 4 4 4 4 4 4 4 4 0 4 4 4 4 4 4 4 4 3 4 4 4 4 4 4 4 4 4 0 4 
4 3 4 4 4 4 4 4 4 4 4 3 4 4 4 4 4 4 4 4 0 4 4 4 4 4 4 4 4 4 3 4 
4 0 3 0 3 0 3 20 3 0 3 0 4 4 4 4 4 4 4 4 3 0 3 0 3 0 3 0 3 0 0 4 
4 3 4 4 4 4 4 4 4 4 4 3 4 4 4 4 4 4 4 4 0 4 4 4 4 4 4 4 4 4 3 4 
4 0 4 4 4 4 4 4 4 4 4 0 4 4 4 4 4 4 4 4 3 4 4 4 4 4 4 4 4 4 0 4 
4 3 4 4 4 4 4 4 4 4 4 3 4 4 4 4 4 4 4 4 0 4 4 4 4 4 4 4 4 4 3 4 
4 0 4 4 4 4 4 4 4 4 4 0 4 4 4 4 4 4 4 4 3 4 4 4 4 4 4 4 4 4 0 4 
4 3 4 4 4 4 4 4 4 4 4 3 4 4 4 4 4 4 4 4 0 4 4 4 4 4 4 4 4 4 3 4 
4 0 4 4 4 4 4 4 4 4 4 0 4 4 4 4 4 4 4 4 3 4 4 4 4 4 4 4 4 4 0 4 
4 3 0 3 0 3 0 3 0 4 4 3 0 3 0 3 5 3 0 3 0 4 4 0 3 0 3 0 3 0 3 4 
4 4 4 4 4 4 4 4 3 4 4 4 4 4 4 4 4 4 4 4 4 4 4 3 4 4 4 4 4 4 4 4 
4 3 0 3 0 3 0 3 0 4 4 4 4 4 4 4 4 4 4 4 4 4 4 0 3 0 3 0 3 0 3 4 
4 0 4 4 4 4 4 4 4 4 4 4 4 4 4 4 4 4 4 4 4 4 4 4 4 4 4 4 4 4 0 4 
4 3 4 4 4 4 4 4 4 4 4 4 4 4 4 4 4 4 4 4 4 4 4 4 4 4 4 4 4 4 3 4 
4 0 4 4 4 4 4 4 4 4 4 4 4 4 4 4 4 4 4 4 4 4 4 4 4 4 4 4 4 4 0 4 
4 3 4 4 4 4 4 4 4 4 4 4 4 4 4 4 4 4 4 4 4 4 4 4 4 4 4 4 4 4 3 4 
4 21 4 4 4 4 4 4 4 4 4 4 4 4 4 4 4 4 4 4 4 4 4 4 4 4 4 4 4 4 0 4 
4 3 4 4 4 4 4 4 4 4 4 4 4 4 4 4 4 4 4 4 4 4 4 4 4 4 4 4 4 4 3 4 
4 0 3 0 3 0 3 0 3 4 4 4 4 4 4 4 4 4 4 4 4 4 4 3 0 3 0 3 0 3 22 4 
4 4 4 4 4 4 4 4 0 4 4 4 0 3 0 3 0 3 0 3 4 4 4 0 4 4 4 4 4 4 4 4 
4 0 3 0 3 0 3 0 3 4 4 4 3 4 4 4 4 4 4 0 4 4 4 3 0 3 0 3 0 3 0 4 
4 3 4 4 4 4 4 4 4 4 4 4 0 4 4 4 4 4 4 3 4 4 4 4 4 4 4 4 4 4 3 4 
4 0 4 4 4 4 4 4 4 4 4 4 3 4 4 4 4 4 4 0 4 4 4 4 4 4 4 4 4 4 0 4 
4 3 4 4 4 4 4 4 4 4 4 4 0 4 4 4 4 4 4 3 4 4 4 4 4 4 4 4 4 4 3 4 
4 0 4 4 4 4 4 4 4 4 4 4 3 4 4 4 4 4 4 0 4 4 4 4 4 4 4 4 4 4 0 4 
4 3 4 4 4 4 4 4 4 4 4 4 0 4 4 4 4 4 4 3 4 4 4 4 4 4 4 4 4 4 3 4 
4 0 3 0 3 0 3 0 3 0 3 0 3 4 4 4 4 4 4 0 3 0 3 0 3 0 3 0 3 0 0 4 
4 4 4 4 4 4 4 3 4 4 4 4 4 4 4 4 4 4 4 4 4 4 4 4 0 4 4 4 4 4 4 4 
4 4 4 4 4 4 4 0 4 4 4 4 4 4 4 4 4 4 4 4 4 4 4 4 3 4 4 4 4 4 4 4 
4 4 4 4 4 4 4 3 4 4 4 4 4 4 4 4 4 4 4 4 4 4 4 4 0 4 4 4 4 4 4 4 
4 0 3 0 3 0 3 0 4 4 4 4 4 4 4 4 4 4 4 4 4 4 4 4 3 0 3 0 3 0 3 4 
4 3 4 4 4 4 4 4 4 4 4 4 4 4 4 4 4 4 4 4 4 4 4 4 4 4 4 4 4 4 0 4 
4 0 4 4 4 4 4 4 4 4 4 4 4 4 4 4 4 4 4 4 4 4 4 4 4 4 4 4 4 4 3 4 
4 3 4 4 4 4 4 4 4 4 4 4 4 4 4 4 4 4 4 4 4 4 4 4 4 4 4 4 4 4 20 4 
4 0 3 0 3 0 3 0 3 0 3 0 3 0 3 0 3 0 3 0 3 0 3 0 3 0 3 0 3 0 3 4
4 4 4 4 4 4 4 4 4 4 4 4 4 4 4 4 4 4 4 4 4 4 4 4 4 4 4 4 4 4 0 4 
4 0 3 0 3 0 3 0 3 0 3 0 3 0 3 0 3 0 3 0 3 0 3 0 3 0 3 0 3 0 3 4 
4 3 4 4 4 4 4 4 4 4 4 4 4 4 4 4 4 4 4 4 4 4 4 4 4 4 4 4 4 4 0 4 
4 0 3 0 3 0 3 0 3 4 4 4 4 4 4 4 4 4 4 4 4 4 4 3 0 3 0 3 0 3 0 4 
4 4 4 4 4 4 4 4 0 4 4 4 4 4 4 4 4 4 4 4 4 4 4 0 4 4 4 4 4 4 4 4 
4 0 3 0 3 0 3 0 3 4 4 4 4 4 4 4 4 4 4 4 4 4 4 3 0 3 0 3 0 3 0 4 
4 3 4 4 4 4 4 4 4 4 4 4 4 4 4 4 4 4 4 4 4 4 4 4 4 4 4 4 4 4 3 4 
4 0 4 4 4 4 4 4 4 4 4 4 4 4 4 4 4 4 4 4 4 4 4 4 4 4 4 4 4 4 0 4 
4 3 4 4 4 4 4 4 4 4 4 0 3 0 3 0 3 0 3 0 3 4 4 4 4 4 4 4 4 4 3 4 
4 0 4 4 4 4 4 4 4 4 4 3 4 4 4 4 4 4 4 4 0 4 4 4 4 4 4 4 4 4 0 4 
4 3 4 4 4 4 4 4 4 4 4 0 4 4 4 4 4 4 4 4 3 4 4 4 4 4 4 4 4 4 3 4 
4 0 4 4 4 4 4 4 4 4 4 3 4 4 4 4 4 4 4 4 0 4 4 4 4 4 4 4 4 4 0 4 
4 3 4 4 4 4 4 4 4 4 4 0 4 4 4 4 4 4 4 4 3 4 4 4 4 4 4 4 4 4 3 4 
4 0 4 4 4 4 4 4 4 4 4 3 4 4 4 4 4 4 4 4 0 4 4 4 4 4 4 4 4 4 0 4 
4 3 4 4 4 4 4 4 4 4 4 0 4 4 4 4 4 4 4 4 3 4 4 4 4 4 4 4 4 4 3 4 
4 0 4 4 4 4 4 4 4 4 4 3 4 4 4 4 4 4 4 4 0 4 4 4 4 4 4 4 4 4 0 4 
4 3 4 4 4 4 4 4 4 4 4 0 4 4 4 4 4 4 4 4 3 4 4 4 4 4 4 4 4 4 3 4 
4 0 3 0 3 0 3 0 3 0 3 0 4 4 4 4 4 4 4 4 0 3 0 3 0 3 0 3 0 3 0 4 
4 3 4 4 4 4 4 4 4 4 4 0 4 4 4 4 4 4 4 4 3 4 4 4 4 4 4 4 4 4 3 4 
4 0 4 4 4 4 4 4 4 4 4 3 4 4 4 4 4 4 4 4 0 4 4 4 4 4 4 4 4 4 0 4 
4 3 4 4 4 4 4 4 4 4 4 0 4 4 4 4 4 4 4 4 3 4 4 4 4 4 4 4 4 4 3 4
4 5 0 3 0 3 0 3 0 3 0 3 4 4 4 4 4 4 4 4 0 3 0 3 0 3 0 3 0 3 5 4
4 4 4 4 4 4 4 4 4 4 4 4 4 4 4 4 4 4 4 4 4 4 4 4 4 4 4 4 4 4 4 4
 